S ███████████████████
      █ █     █ █ █ █
███ ███ █████ █ █ █ █
█   █  O  █         █
█ ███ █████ █ ███ █ █
█B█ █       █ █ █ █ █
█ █ █ █ █████ █ ███ █
█B  █ █   █     █ █ █
█ █ █ █████ █ ███ ███
█ █ █ O   █ █       █
███O█ █ ███ ███ █ ███
█     █   █ █ O █ █ █
█ █ ███ ███ ███ █ █ █
█ █ █ █ █   █   █   █
█ ███ █ █ █ █████ █ █
█   █   B █       █ █
███ ███ ███████ █████
█     █   █ █     █ █
█ █ █████ █ █ █████ █
█ █         █       
███████████████████G
